########$########
#...............#
#...............#
$.......@.......$
#...............#
#...............#
########$########